{
  "0": "BRB",
  "1": "CHC",
  "2": "CQC",
  "3": "CYP",
  "4": "DEU",
  "5": "EIU",
  "6": "GUP",
  "7": "MGD",
  "8": "MUL",
  "9": "NET",
  "10": "NWH",
  "11": "SEQ",
  "12": "WET"
}